************
*0>00001000*
*****000000*
*000*000000*
*3*00000000*
************


************
* >    1   *
*****      *
*   *      *
*3*        *
************


*****************
*0>0000100000000*
*********0000000*
*000*00000000000*
*3*00000000******
*0**********0000*
*000000000000500*
*****************


*****************
* >    1        *
*********       *
*   *           *
*3*        ******
* **********    *
*            5  *
*****************